Username,User ID,Price,Strength,Intel,Combined
-FAM-_MelaninBrujaMisses_-FAM-,1555557231,1.18561E+13,23923240,14166948,38090188
-SIN-SEXY-MARANX-,448126708,1.17579E+13,25123666,11334178,36457844
Blue-Mist,12040266,1.17368E+13,24006356,9913442,33919798
VladimirPutin,1823845503,1.18561E+13,28508612,4665054,33173666
Tori-_,1253078350,1.17579E+13,15985390,15985390,31970780
DemonsGrace-iCyRain,1286624765,1.17368E+13,15363248,15883606,31246854
AlphaDomination,1991705418,1.19162E+13,24533246,6436590,30969836
AnshGupta,45263930,1.19689E+13,22941374,7992620,30933994
-Pain-,448240658,1.18561E+13,15813492,14903436,30716928
PinkSkies-,448056454,1.19767E+13,23186156,7437864,30624020
Saym,816887833,1.17368E+13,10892728,19669838,30562566
multistriker300,1622545317,1.19162E+13,25190256,5131264,30321520
pandaxoxo,1991370926,1.17963E+13,17026054,13267690,30293744
-SaSsyBoo-,1589006533,1.17368E+13,22570134,7150848,29720982
Iuckiest_Iady,2125582344,1.17963E+13,14791678,14791678,29583356
_-SuGaRsXtY9-_,280415709,1.17368E+13,20542932,8738330,29281262
Dark_Ninetales,2024969249,1.17757E+13,19683140,9275980,28959120
MCziRin,1152828622,1.19377E+13,21863596,7016272,28879868
DespicabIe,682977378,1.18061E+13,14378714,14378714,28757428
Tyr,1991272501,1.17963E+13,14389036,14354422,28743458
Rivulose,180212664,1.17961E+13,14323266,14306660,28629926
KapG,1219928086,1.17368E+13,14924874,13357622,28282496
iSleepy,1790218735,1.19162E+13,24268610,3971226,28239836
Firestorm,1119312879,1.17368E+13,14118838,14118838,28237676
gagan1993,1488143937,1.17963E+13,23480638,4673306,28153944
CoIonSink,481332330,1.1801E+13,21118184,6483264,27601448
xLustx3,548839824,1.18061E+13,14646314,12841340,27487654
_-_CaptainSpaulding_-_,1655790428,1.18894E+13,21662372,5801976,27464348
Psycho_Boy,1857925827,1.17244E+13,18394530,9065114,27459644
----MooJoo----,246865226,1.19592E+13,16988156,10345752,27333908
sjy,1286647883,1.19724E+13,18516782,8578078,27094860
_-Meg-_,2091943660,1.17368E+13,13781960,13284692,27066652
LetMeLickYourLollipop,1420915027,1.1959E+13,22488546,4095464,26584010
KinderJoy,817257551,1.18659E+13,22260142,4226542,26486684
Fun,548819942,1.17407E+13,10522978,15955094,26478072
isnake_luv2Slytherinyourdorm,514859731,1.17368E+13,13261100,13203968,26465068
_CYNTHIA_,11664064,1.19807E+13,12697798,13701486,26399284
lllllllllIIIIIIIIIIIIIllllllll,1622586259,1.18561E+13,3703238,22630830,26334068
vms,112646585,1.18003E+13,22384368,3831364,26215732
TheGreatCh3wy,1219948786,1.18775E+13,19121694,7008288,26129982
Mercy,1588720639,1.17368E+13,22363654,3659518,26023172
-Alien-DominusTheReversal-,1790384402,1.1783E+13,14938310,11012742,25951052
Obscene,1689370710,1.19162E+13,16109820,9835356,25945176
Rainer_the_Wanderer,783787881,1.17368E+13,21208926,4530190,25739116
Nara_Myra,649289189,1.17368E+13,13865508,11833836,25699344
-Taffy32-,1421315423,1.17963E+13,12639018,12639018,25278036
PrincessKnowsBestUnlikeTheRest,1454713810,1.19767E+13,19285902,5482702,24768604
Vivu-,145968782,1.17962E+13,15498416,8709798,24208214
Rico_Mama_Firefly,145973943,1.19767E+13,15044848,9111258,24156106
SVG-TheFaLLen-StarLord-,1521915605,1.19162E+13,14032232,9906396,23938628
kidraulh-,1186833656,1.19766E+13,13036172,10778742,23814914
ScarLucifer,716200569,1.17368E+13,13693110,10112304,23805414
-Scumbag-,313609063,1.19029E+13,11867256,11867256,23734512
Tiixee,1521624059,1.18561E+13,11236334,12491590,23727924
Jacqs_Umbrella_Academy,481488715,1.19341E+13,8523736,15086144,23609880
dawane,45293642,1.18432E+13,11748850,11748850,23497700
-AD_Khaleesi-,917985492,1.17368E+13,11747248,11747248,23494496
Yxzee,1957714522,1.17963E+13,11937938,11272824,23210762
_Nyx_,1186136403,1.18561E+13,19666378,3513642,23180020
Liar,2125467538,1.17963E+13,11251374,11460592,22711966
Glyn,615701287,1.19516E+13,12203416,10474048,22677464
Rorobearz,1890609694,1.19767E+13,15380380,7297046,22677426
Lassi,1420888444,1.18753E+13,15234054,7337290,22571344
vause,1790756522,1.17895E+13,10363166,11720818,22083984
Ryan-The-Tiger,1756814775,1.17963E+13,10986512,10986512,21973024
NurseBecky,984778409,1.1853E+13,17360278,4473150,21833428
noctem,1991400735,1.18464E+13,18591260,3042220,21633480
xBabyYodaBandz,1756376103,1.18061E+13,8930484,12696620,21627104
Hennessee,313649855,1.18568E+13,14051430,7558502,21609932
-x-EvilSnowWhite-x-,1555486289,1.17963E+13,7429392,13987216,21416608
Cowboy131,951089229,1.18775E+13,18112728,3300792,21413520
Clockwork_Bride,1085400760,1.17963E+13,17104104,4250210,21354314
-KiIIingCactus-,1857466597,1.17963E+13,18277550,2990878,21268428
-Katistrophic-,45590568,1.17368E+13,15304436,5763392,21067828
QUEEN-H,1655983987,1.17963E+13,15259464,5768932,21028396
KikiMoreau,2058546093,1.17963E+13,14539040,6285242,20824282
Halsey,1723099211,1.19348E+13,14567532,6002464,20569996
___GOKU___,1823905441,1.19162E+13,13751644,6623642,20375286
SaintLucifer,45236913,1.17368E+13,13834396,6416200,20250596
KING_MICKEY_NICK,1320353356,1.19098E+13,16002584,4180912,20183496
Secretly_Cobs,951167418,1.19988E+13,14839024,4994772,19833796
Lei,1655928522,1.18273E+13,16604800,2717156,19321956
Paging-Doctor-Meredith-Grey,112207743,1.17368E+13,14776652,3749868,18526520
_Latte,1790146968,1.17368E+13,7592006,10714154,18306160
L0sT-Gh0sT,1085529461,1.17368E+13,8473380,9647670,18121050
Nimrod,884128580,1.18777E+13,15317182,2516038,17833220
-F0X-,582120467,1.17432E+13,11967838,5585760,17553598
StormingBoots,817828983,1.18192E+13,14573446,2962822,17536268
GypsySoul_Ivy,1287125544,1.17368E+13,14723540,2409310,17132850
_Eris,1152610450,1.17534E+13,8841934,8180668,17022602
HeartlessJosh,1555295669,1.18175E+13,8262042,8262042,16524084
iRhymeWithWitch,179491707,1.17355E+13,13691976,2459490,16151466
-Benihime-,615549004,1.18561E+13,8586082,7506386,16092468
LocaIPoptart,816920575,1.18388E+13,5660216,8948852,14609068
logyrian,783525249,1.17888E+13,2341648,11151710,13493358
CrackheadbarneywithanAK-47,11569797,1.18561E+13,9819004,3286704,13105708
-Joesph_the_sailor-,1018604546,1.19377E+13,8033518,4635502,12669020
PhilnHigh,1118841444,1.17963E+13,2244082,9651096,11895178
FollowThis,1353994313,1.19982E+13,3352714,548816,3901530
b291,1287515704,1.18174E+13,15120,15120,30240
Plexy,1488398653,1.18681E+13,10842,9478,20320
khaladzki,1454706498,1.17241E+13,7560,7560,15120
ericapooh,1051839309,1.17526E+13,7092,6476,13568
gin9e,1186336984,1.17657E+13,1134,1004,2138
--Mario--,1387274602,1.18381E+13,692,772,1464